111111111
100E1C001
1C01P1001
1000000C1
111111111