111111111111111111
100C1C001C001C00C1
1P1000000N10C011E1
111111111111111111