111111111111111111
1C00100C000C100C01
100C1C001C001C00C1
1C11P1000010C011C1
100C000C11N011E001
111111111111111111